Nom du colonne	Example	NB
PatId                         	B01002	Lettre B ou L suivie de 5 chiffres. Si T  = SAFIR-TOR = Pas accepté
Chr                           	chr17	chr + numero du chromosome
Start_Position                	41223094	
Reference_Seq                 	T	Si SNV, Ref et Var sont représentés par une seule base. 
Variant_Seq                   	C	
Global_Conclusion                                                        	 NA   	Ne pas mettre l'accent dans les mots ni caractère spéciaux
Manual_Var_Comment                                           	 NA   	Ne pas mettre l'accent dans les mots ni caractère spéciaux
Manual_Var_Classif            	0	"0 = polymorphisme : 1000genome ou ESP >=1 %
VP = PAS un polymorphisme 1000genome ou ESP <1%) - COSMIC ID present
VPI = PAS un polymorphisme 1000genome ou ESP <1%) - PAS de COSMIC ID 
present - predit deletere par au moins 1 outil
VNP = PAS un polymorphisme 1000genome ou ESP <1%) - PAS de COSMIC ID
present - PAS predit deletere ==> on retrouve les synonymes dedans"
Variant_Freq                  	51.8	"Utilise ""point"" mais pas ""virgule""; un chiffre entre 0 et 100"
Position_Cov                  	396	Utiliser la même qualité de filtres pour cette information et «Variant Cov »
End_Position                  	41223094	
Strand                        	-	"utilise ""-"" ou ""+"" ou NA"
Variant_Cov                   	205	Utiliser la même qualité de filtre pour cette information et « Position Cov »
Quality                       	2132.79	"Utilise ""point"" mais pas ""virgule"" – Mettre NA si PGM non utilisé"
Strand_Bias                   	0.5019	"Utilise ""point"" mais pas ""virgule"" – valeur entre 0 et 1"
Amplicon_Ref                  	AMPL3658889274	
Gene_Symbol                   	BRCA1	
Protein_Change                	p.Ser1634Gly	En suivant les recommandations HGVS, reporter les variant avec les amino acides en code 3 lettres
Exon                          	16	"Mettre juste le numero d'exon mais pas ""exonXX"" /  ""exXX"" "
RefSeq_Id                     	NM_007300.3	Se limiter à la liste des NM définie pour le projet
cDNA_Change                   	c.4900A>G	
Codon                         	1634	Reporter le numéro de l'exon, pas le p.
Type                          	SNP	"Utilise ""SNP"", ""INS"" ou ""DEL"""
MAF_classification            	missense_variant	lister tout ce qui est accepter
ESP_Freq                      	0.326628	"Utilise ""point"" mais pas ""virgule"", version base de données XX"
by1000G_Freq                  	0.36147757255936674	"Utilise ""point"" mais pas ""virgule"", version base de données XX"
DbSNP_Id                      	rs1799966	version base de données XX
COSMIC_Id                     	COSM3755560,COSM3755559	Ne reporter QUE les COSM ID, pas les informations tissus ou autres informations + version base de données XX
